AAAAAAAAAAAAAAAAAAAAAAAAAAAAAAAAAAAAAAAA
AAAAAAAAAAAAAAAAAAAAAAAAAAAAAAAAAAAAAAAA
AAAAAAAAAAAAAAAAAAAAAAAAAAAAAAAAAAAAAAAA
AAAAA                              AAAAA
AAAAA     E           E            AAAAA
AAAAA                              AAAAA
AAAAA                              AAAAA
AAAAA                              AAAAA
AAAAA                              AAAAA
AAAAA                              AAAAA
AAAAA                              AAAAA
AAAAA                              AAAAA
AAAAA                              AAAAA
AAAAA                              AAAAA
AAAAA                              AAAAA
AAAAA                              AAAAA
AAAAA                              AAAAA
AAAAA                              AAAAA
AAAAA                              AAAAA
AAAAA                              AAAAA
AAAAA                              AAAAA
AAAAA                              AAAAA
AAAAA                              AAAAA
AAAAA                              AAAAA
AAAAAAAAAAAAAAAAAAAAAAAAAAAAAAAAAAAAAAAA
AAAAAAAAAAAAAAAAAAAAAAAAAAAAAAAAAAAAAAAA
AAAAAAAAAAAAAAAAAAAAAAAAAAAAAAAAAAAAAAAA