AAAAAAAAAAAAAAAAAAAAAAAAAAAAAAAAAAAAAAAA
AAAAAAAAAAAAAAAAAAAAAAAAAAAAAAAAAAAAAAAA
AAAAAAAAAAAAAAAAAAAAAAAAAAAAAAAAAAAAAAAA
AAAAA                              AAAAA
AAAAA     E           E            AAAAA
AAAAA                              AAAAA
AAAAA                              AAAAA
AAAAA                              AAAAA
AAAAA                              AAAAA
AAAAA                              AAAAA
AAAAA                              AAAAA
AAAAA                              AAAAA
AAAAA                              AAAAAAAAAAAAAAAAAAAAAAAAAAAAAAAAAAAAAAAAAAAAA
AAAAA                                             HHH        HHH       HHH     A
AAAAA                                             HHH        HHH       HHH     A
AAAAA                              AAAAAAAAAAAAAAAAAAAAAAAAAAAAAAAAAAAAAAAAAAAAA
AAAAA              P               AAAAA
AAAAA                              AAAAA
AAAAA                              AAAAA
AAAAA                       N      AAAAA
AAAAA     N                        AAAAA
AAAAA                              AAAAA
AAAAA                  F           AAAAA
AAAAA                              AAAAA
AAAAAAAAAAAAAAAA      AAAAAAAAAAAAAAAAAA
AAAAAAAAAAAAAAAA      AAAAAAAAAAAAAAAAAA
AAAAAAAAAAAAAAAA      AAAAAAAAAAAAAAAAAA
          AAAAAA      AAAAAA            
          AAAAAAHHHHHHAAAAAA            
          AAAAAAHHHHHHAAAAAA            
          AAAAAAHHHHHHAAAAAA            
          AAAAAAHHHHHHAAAAAA            
          AAAAAAAAAAAAAAAAAA            