AAAAAAAAAAAAAAAAAAAAAAAAAAAAAAAAAAAAAAAA
AAAAAAAAAAAAAAAAAAAAAAAAAAAAAAAAAAAAAAAA
AAAAAAAAAAAAAAAAAAAAAAAAAAAAAAAAAAAAAAAA
AAAAA                              AAAAA
AAAAA     E           E            AAAAA
AAAAA                              AAAAA
AAAAA                              AAAAA
AAAAA                              AAAAA
AAAAA                              AAAAA
AAAAA                              AAAAA
AAAAA                              AAAAA
AAAAA                              AAAAA
AAAAA                              AAAAA
AAAAA                              AAAAA
AAAAA                              AAAAA
AAAAA                              AAAAA
AAAAA                              AAAAA
AAAAA                              AAAAA
AAAAA                              AAAAA
AAAAA                              AAAAA
AAAAA                              AAAAA
AAAAA                              AAAAA
AAAAA                              AAAAA
AAAAA                              AAAAA
AAAAAAAAAAAAAAAA      AAAAAAAAAAAAAAAAAA
AAAAAAAAAAAAAAAA      AAAAAAAAAAAAAAAAAA
AAAAAAAAAAAAAAAA      AAAAAAAAAAAAAAAAAA
          AAAAAA      AAAAAA            
          AAAAAAHHHHHHAAAAAA            
          AAAAAAHHHHHHAAAAAA            
          AAAAAAHHHHHHAAAAAA            
          AAAAAAHHHHHHAAAAAA            
          AAAAAAAAAAAAAAAAAA            